.........
.........
.........
...*****.
***......
....*....
....*....