###############
#....#....##..#
#.##.#.##.....#
#@#..#.....#..#
##.........#.##
#.....#..#....#
#......#..#..##
####.....######
#....#....##..#
#.##.#.##.....#
#.#..#.....#..#
##.........#.##
#.....#..#....#
#......#..#..##
#.....#..#....#
###############