################
.@#....#.#..#..#
#.#.##.#.#.###.#
#.#.#..#.#.....#
#.#.#.##.#####.#
#.#.#.#...#....#
#.#.#.###...##.#
#...#...#####..#
#######.#...#.##
#.......#.#.#..#
#.###.#...#.##.#
#.#...#####....#
#.#.###...###.##
#.#..#..#.##...#
#.##...##....#..
################